X XXXXXXXXXXXXXXXXXXXXXXXXXXXXXXXXXXXXXXXXXXXXXXXXXXXXXXXXXXXXX
X   X       X   X                 X     X   X   X         X   X
XXX XXX XXX XXX X XXXXXXXXX XXXXX X XXX X X X X XXXXXXX X X X X
X X     X X   X   X X     X     X   X X   X   X         X   X X
X XXXXXXX XXX XXX X X X X XXXXX XXXXX XXXXXXXXXXXXXXXXXXXXXXX X
X X         X   X X   X X     X     X                     X X X
X X XXX XXXXXXX X XXXXX XXXXXXXXXXX X XXXXX XXXXX XXXXXXX X X X
X X   X       X X       X   X     X X X     X     X   X     X X
X XXX XXXXX X X XXX XXXXX X X XXX X X X XXXXX XXXXX X XXXXXXX X
X   X   X   X X   X X   X X   X   X X X X X   X   X X         X
X X XXX X XXXXXXX X X X X XXXXX XXX XXX X X XXX X X XXXXXXXXXXX
X X X   X       X X X X   X   X   X   X X     X X X       X   X
X X X XXXXXXXXX X X X XXXXX X XXX X X X XXXXXXX X X XXXXXXX X X
X X   X     X   X X X       X X   X X X         X X X     X X X
X XXXXXXX XXX XXX X XXXXXXXXX XXX XXX XXXXXXXXXXX X X XXX X X X
X X       X   X   X   X     X   X     X         X X X   X   X X
X X XXXXXXX X X XXXXXXX XXX X X X XXXXX XXXXXXX X X X XXXXX X X
X X X       X X         X X X X X X     X     X X   X X   X X X
X X X XXXXXXX XXXXXXXXXXX X X X XXX XXXXXXXXX X XXXXX X X X X X
X X X X                   X X X   X X         X       X X X X X
X X X XXXXXXXXXXXXXXX XXXXX X XXX X XXX XXXXX XXXXXXXXX X XXX X
X X X X       X   X   X     X   X X     X X   X         X     X
X X X X XXXXX X X X XXX XXXXXXX X XXXXXXX X XXX X XXXXXXXXXXX X
X   X   X   X X X     X X       X   X   X   X   X X   X   X   X
XXX X XXX X X XXXXXXX X XXXXXXXXX XXX X X XXX XXX X X XXX X XXX
X   X   X X X     X   X       X   X   X     X   X X X X   X   X
X XXX X XXX XXXXX XXXXXXXXXXX X XXX XXXXXXX XXX XXX X X XXXXX X
X     X   X     X       X     X X     X   X   X     X X       X
X XXXXXXX X XXX XXXXXXX X XXXXX X XXXXX X XXX XXXXXXX XXXXXXX X
X   X     X X X       X   X X     X     X   X   X     X     X X
X X X XXXXX X XXXXXXX XXXXX X XXXXX XXXXXXX XXX X XXXXX XXX X X
X X X X   X         X         X   X X   X X   X X X       X X X
X XXX X X XXXXXXXXX XXXXXXXXXXX X X X X X XXX X X X XXXXXXX X X
X   X X X   X     X   X   X     X   X X X X   X X   X   X   X X
X X X X XXX X XXX X XXX X X XXXXXXXXX X X X XXXXXXXXX X X XXX X
X X X   X X X   X   X   X X X         X   X           X   X   X
XXX XXXXX X XXX XXXXX XXX X X XXX XXXXXXX XXXXXXXXXXXXXXXXX XXX
X         X X       X X     X   X       X X       X       X X X
X XXX XXXXX X XXXXXXX XXXXX X XXXXXXXXX XXX X XXX X XXXXXXX X X
X   X X     X X       X   X X         X     X X     X     X X X
XXX X X XXXXX X XXXXXXX X XXX XXXXXXX X XXXXX X XXXXX XXX X X X
X   X X X     X X       X     X   X   X     X X X   X   X X   X
X XXX X X XXXXX X XXXXXXXXXXXXX X X XXXXXXXXX X X X XXX X XXX X
X X X X X   X   X X       X     X X     X     X X X   X X   X X
X X X X XXXXX X X XXXXX X X XXX X XXXXX X XXX XXX X XXX X XXX X
X X         X X X X   X X X   X X     X X   X X   X     X   X X
X XXXXXXXXX X XXX X X X XXXXX X XXXXXXX XXX X X XXXXXXXXXXX X X
X         X X     X X X       X     X   X   X X X         X   X
X XXXXX XXX X XXXXX X XXXXX XXXXXXX X XXX XXXXX X XXXXXXX XXXXX
X   X X     X       X X   X       X X X   X     X X   X       X
XXX X XXXXXXXXXXXXXXX X X XXX XXXXX X X XXX XXXXX X X X XXXXX X
X X       X   X   X     X   X X     X X     X     X X   X X   X
X XXXXXXX X X X X XXXXXXXXX XXX XXX X X XXXXXXXXX X XXXXX X XXX
X       X X X   X   X         X X   X X X       X X X     X X X
X X XXXXX X XXXXXXX XXXXXXXXX X XXXXX X X XXXXX X X XXX XXX X X
X X     X   X     X X     X     X     X X   X X X X   X   X   X
X XXXXX XXXXXXX XXX X XXX XXXXXXX XXXXX XXX X X XXX X X X XXX X
X X   X         X   X X     X   X X   X     X X   X X X X X   X
X XXX X XXX XXXXX XXX XXXXX X X X X X XXXXXXX XXX XXX XXX X XXX
X   X X   X X     X     X X X X X X X           X   X X   X X X
XXX X XXX XXX XXXXXXXXX X X X X X X XXXXXXX XXXXXXX X X XXX X X
X       X               X     X   X       X           X       X
XXXXXXXXXXXXXXXXXXXXXXXXXXXXXXXXXXXXXXXXXXXXXXXXXXXXXXXXXXXXX X
